6.ox
o.o......o..
......o....o
.....o......
...o........
.o..........
........ooo.
